1111111111111111111111111111111111111111
1C100010111011101011E00C1000101110111011
10101P1111111111111000001010111111111111
1000000000000000001100000000H00000000001
10111C1011111010111C0000111C101111101011
1111111011101010H0000F001111101110101001
100011001111C001110000000111011111C00011
1C1010101111111010100H0C1010101111111011
1110111010001C101110000010111010001C1011
1000C00C10101000000H000000C00C1010100001
1111111111111111111111111111111111111111