111111111111111111111111111111111111
111111111111111111111111101111111111
1P0000000000010C111000000000000E1111
100000000C000100C00F0C0000C000111111
1000000000000000000000000000000C0001
10000H0000000E0000E00000000000000001
111111111111111111111111111111111101
111111111111111111111111111111111111