1111
11C1
1P11
1111
1E11
1111
1111